F 80,60,40
C 30,30,50

NO textures/north.xpm
SO textures/south.xpm
WE textures/west.xpm
EA textures/east.xpm

              1
             111
            11011
           1100011
          110101011
         11010001011
        1101110111011
       110000000000011
      11011101110111011
     1100000100100000011
    110111010001011101011
   11000001011101000001011
  1101110100000010111010011
 110000010111110100000100011
11011101000N00001011101011011
1111111111111111111111111111111
