NO ./textures/north.xpm
SO ./textures/south.xpm
WE ./textures/west.xpm
EA ./textures/east.xpm

F 100,100,100
C 200,200,200

11111111111111111111111111111111111111111111111111
10000000000000000000000000000000000000000000000001
10111111111111111111111111111111111111111111111101
10100000000000000000000000000000000000000000000101
10101111111111111111111111111111111111111111110101
10101000000000000000000000000000000000000000010101
10101011111111111111111111111111111111111111010101
10101010000000000000000000000000000000000001010101
10101010111111111111111111111111111111111101010101
10101010100000000000000000000000000000000101010101
10101010101111111111111111111111111111110101010101
10101010101000000000000N00000000000000001010101011
10101010101111111111111111111111111111110101010101
10101010100000000000000000000000000000000101010101
10101010111111111111111111111111111111111101010101
10101010000000000000000000000000000000000001010101
10101011111111111111111111111111111111111111010101
10101000000000000000000000000000000000000000010101
10101111111111111111111111111111111111111111110101
10100000000000000000000000000000000000000000000101
10111111111111111111111111111111111111111111111101
10000000000000000000000000000000000000000000000001
10101000000000000000000000000000000000000000010101
10101111111111111111111111111111111111111111110101
10100000000000000000000000000000000000000000000101
10111111111111111111111111111111111111111111111101
10000000000000000000000000000000000000000000000001
10101000000000000000000000000000000000000000010101
10101111111111111111111111111111111111111111110101
10100000000000000000000000000000000000000000000101
10111111111111111111111111111111111111111111111101
10000000000000000000000000000000000000000000000001
10101000000000000000000000000000000000000000010101
10101111111111111111111111111111111111111111110101
10100000000000000000000000000000000000000000000101
10111111111111111111111111111111111111111111111101
10000000000000000000000000000000000000000000000001
10101000000000000000000000000000000000000000010101
10101111111111111111111111111111111111111111110101
10100000000000000000000000000000000000000000000101
10111111111111111111111111111111111111111111111101
10000000000000000000000000000000000000000000000001
10101000000000000000000000000000000000000000010101
10101111111111111111111111111111111111111111110101
10100000000000000000000000000000000000000000000101
10111111111111111111111111111111111111111111111101
10000000000000000000000000000000000000000000000001
10101000000000000000000000000000000000000000010101
10101111111111111111111111111111111111111111110101
10100000000000000000000000000000000000000000000101
10111111111111111111111111111111111111111111111101
10000000000000000000000000000000000000000000000001
10101000000000000000000000000000000000000000010101
10101111111111111111111111111111111111111111110101
10100000000000000000000000000000000000000000000101
10111111111111111111111111111111111111111111111101
10000000000000000000000000000000000000000000000001
10101000000000000000000000000000000000000000010101
10101111111111111111111111111111111111111111110101
10100000000000000000000000000000000000000000000101
10111111111111111111111111111111111111111111111101
10000000000000000000000000000000000000000000000001
10101000000000000000000000000000000000000000010101
10101111111111111111111111111111111111111111110101
10100000000000000000000000000000000000000000000101
10111111111111111111111111111111111111111111111101
10000000000000000000000000000000000000000000000001
10101000000000000000000000000000000000000000010101
10101111111111111111111111111111111111111111110101
10100000000000000000000000000000000000000000000101
10111111111111111111111111111111111111111111111101
10000000000000000000000000000000000000000000000001
10101000000000000000000000000000000000000000010101
10101111111111111111111111111111111111111111110101
10100000000000000000000000000000000000000000000101
10111111111111111111111111111111111111111111111101
10000000000000000000000000000000000000000000000001
10101000000000000000000000000000000000000000010101
10101111111111111111111111111111111111111111110101
10100000000000000000000000000000000000000000000101
10111111111111111111111111111111111111111111111101
10000000000000000000000000000000000000000000000001
10101000000000000000000000000000000000000000010101
10101111111111111111111111111111111111111111110101
10100000000000000000000000000000000000000000000101
10111111111111111111111111111111111111111111111101
10000000000000000000000000000000000000000000000001
10101000000000000000000000000000000000000000010101
10101111111111111111111111111111111111111111110101
10100000000000000000000000000000000000000000000101
10111111111111111111111111111111111111111111111101
10000000000000000000000000000000000000000000000001
10101000000000000000000000000000000000000000010101
10101111111111111111111111111111111111111111110101
10100000000000000000000000000000000000000000000101
10111111111111111111111111111111111111111111111101
10000000000000000000000000000000000000000000000001
10101000000000000000000000000000000000000000010101
10101111111111111111111111111111111111111111110101
10100000000000000000000000000000000000000000000101
10111111111111111111111111111111111111111111111101
10000000000000000000000000000000000000000000000001
10101000000000000000000000000000000000000000010101
10101111111111111111111111111111111111111111110101
10100000000000000000000000000000000000000000000101
10111111111111111111111111111111111111111111111101
10000000000000000000000000000000000000000000000001
10101111111111111111111111111111111111111111110101
10100000000000000000000000000000000000000000000101
10111111111111111111111111111111111111111111111101
10000000000000000000000000000000000000000000000001
10101111111111111111111111111111111111111111110101
10100000000000000000000000000000000000000000000101
10111111111111111111111111111111111111111111111101
10000000000000000000000000000000000000000000000001
10101111111111111111111111111111111111111111110101
10100000000000000000000000000000000000000000000101
10111111111111111111111111111111111111111111111101
10000000000000000000000000000000000000000000000001
10101111111111111111111111111111111111111111110101
10100000000000000000000000000000000000000000000101
10111111111111111111111111111111111111111111111101
10000000000000000000000000000000000000000000000001
10101111111111111111111111111111111111111111110101
10100000000000000000000000000000000000000000000101
10111111111111111111111111111111111111111111111101
10000000000000000000000000000000000000000000000001
10101111111111111111111111111111111111111111110101
10100000000000000000000000000000000000000000000101
10111111111111111111111111111111111111111111111101
10000000000000000000000000000000000000000000000001
10101111111111111111111111111111111111111111110101
10100000000000000000000000000000000000000000000101
10111111111111111111111111111111111111111111111101
10000000000000000000000000000000000000000000000001
10101111111111111111111111111111111111111111110101
10100000000000000000000000000000000000000000000101
10111111111111111111111111111111111111111111111101
10000000000000000000000000000000000000000000000001
10101111111111111111111111111111111111111111110101
10100000000000000000000000000000000000000000000101
10111111111111111111111111111111111111111111111101
10000000000000000000000000000000000000000000000001
10101111111111111111111111111111111111111111110101
10100000000000000000000000000000000000000000000101
10111111111111111111111111111111111111111111111101
10000000000000000000000000000000000000000000000001
10101111111111111111111111111111111111111111110101
10100000000000000000000000000000000000000000000101
10111111111111111111111111111111111111111111111101
10000000000000000000000000000000000000000000000001
10101111111111111111111111111111111111111111110101
10100000000000000000000000000000000000000000000101
10111111111111111111111111111111111111111111111101
10000000000000000000000000000000000000000000000001
10101111111111111111111111111111111111111111110101
10100000000000000000000000000000000000000000000101
10111111111111111111111111111111111111111111111101
10000000000000000000000000000000000000000000000001
10101111111111111111111111111111111111111111110101
10100000000000000000000000000000000000000000000101
10111111111111111111111111111111111111111111111101
10000000000000000000000000000000000000000000000001
10101111111111111111111111111111111111111111110101
10100000000000000000000000000000000000000000000101
10111111111111111111111111111111111111111111111101
10000000000000000000000000000000000000000000000001
10101111111111111111111111111111111111111111110101
10100000000000000000000000000000000000000000000101
10111111111111111111111111111111111111111111111101
10000000000000000000000000000000000000000000000001
10101111111111111111111111111111111111111111110101
10100000000000000000000000000000000000000000000101
10111111111111111111111111111111111111111111111101
10000000000000000000000000000000000000000000000001
10101111111111111111111111111111111111111111110101
10100000000000000000000000000000000000000000000101
10111111111111111111111111111111111111111111111101
10000000000000000000000000000000000000000000000001
10101111111111111111111111111111111111111111110101
10100000000000000000000000000000000000000000000101
10111111111111111111111111111111111111111111111101
10000000000000000000000000000000000000000000000001
10101111111111111111111111111111111111111111110101
10100000000000000000000000000000000000000000000101
10111111111111111111111111111111111111111111111101
10000000000000000000000000000000000000000000000001
10101111111111111111111111111111111111111111110101
10100000000000000000000000000000000000000000000101
10111111111111111111111111111111111111111111111101
10000000000000000000000000000000000000000000000001
10101111111111111111111111111111111111111111110101
10100000000000000000000000000000000000000000000101
10111111111111111111111111111111111111111111111101
10000000000000000000000000000000000000000000000001
10101111111111111111111111111111111111111111110101
10100000000000000000000000000000000000000000000101
10111111111111111111111111111111111111111111111101
10000000000000000000000000000000000000000000000001
10101111111111111111111111111111111111111111110101
10100000000000000000000000000000000000000000000101
10111111111111111111111111111111111111111111111101
10000000000000000000000000000000000000000000000001
10101111111111111111111111111111111111111111110101
10100000000000000000000000000000000000000000000101
10111111111111111111111111111111111111111111111101
10000000000000000000000000000000000000000000000001
10101111111111111111111111111111111111111111110101
10100000000000000000000000000000000000000000000101
10111111111111111111111111111111111111111111111101
10000000000000000000000000000000000000000000000001
10101111111111111111111111111111111111111111110101
10100000000000000000000000000000000000000000000101
10111111111111111111111111111111111111111111111101
10000000000000000000000000000000000000000000000001
10101111111111111111111111111111111111111111110101
10100000000000000000000000000000000000000000000101
10111111111111111111111111111111111111111111111101
10000000000000000000000000000000000000000000000001
10101111111111111111111111111111111111111111110101
10100000000000000000000000000000000000000000000101
10111111111111111111111111111111111111111111111101
10000000000000000000000000000000000000000000000001
10101111111111111111111111111111111111111111110101
10100000000000000000000000000000000000000000000101
10111111111111111111111111111111111111111111111101
10000000000000000000000000000000000000000000000001
10101111111111111111111111111111111111111111110101
10100000000000000000000000000000000000000000000101
10111111111111111111111111111111111111111111111101
10000000000000000000000000000000000000000000000001
10101111111111111111111111111111111111111111110101
10100000000000000000000000000000000000000000000101
10111111111111111111111111111111111111111111111101
10000000000000000000000000000000000000000000000001
10101111111111111111111111111111111111111111110101
10100000000000000000000000000000000000000000000101
10111111111111111111111111111111111111111111111101
10000000000000000000000000000000000000000000000001
10101111111111111111111111111111111111111111110101
10100000000000000000000000000000000000000000000101
10111111111111111111111111111111111111111111111101
10000000000000000000000000000000000000000000000001
10101111111111111111111111111111111111111111110101
10100000000000000000000000000000000000000000000101
10111111111111111111111111111111111111111111111101
10000000000000000000000000000000000000000000000001
10101111111111111111111111111111111111111111110101
10100000000000000000000000000000000000000000000101
10111111111111111111111111111111111111111111111101
10000000000000000000000000000000000000000000000001
10101111111111111111111111111111111111111111110101
10100000000000000000000000000000000000000000000101
10111111111111111111111111111111111111111111111101
10000000000000000000000000000000000000000000000001
10101111111111111111111111111111111111111111110101
10100000000000000000000000000000000000000000000101
10111111111111111111111111111111111111111111111101
10000000000000000000000000000000000000000000000001
10101111111111111111111111111111111111111111110101
10100000000000000000000000000000000000000000000101
10111111111111111111111111111111111111111111111101
10000000000000000000000000000000000000000000000001
10101111111111111111111111111111111111111111110101
10100000000000000000000000000000000000000000000101
10111111111111111111111111111111111111111111111101
10000000000000000000000000000000000000000000000001
10101111111111111111111111111111111111111111110101
10100000000000000000000000000000000000000000000101
10111111111111111111111111111111111111111111111101
10000000000000000000000000000000000000000000000001
10101111111111111111111111111111111111111111110101
10100000000000000000000000000000000000000000000101
10111111111111111111111111111111111111111111111101
10000000000000000000000000000000000000000000000001
10101111111111111111111111111111111111111111110101
10100000000000000000000000000000000000000000000101
10111111111111111111111111111111111111111111111101
10000000000000000000000000000000000000000000000001
10101111111111111111111111111111111111111111110101
10100000000000000000000000000000000000000000000101
10111111111111111111111111111111111111111111111101
10000000000000000000000000000000000000000000000001
10101111111111111111111111111111111111111111110101
10100000000000000000000000000000000000000000000101
10111111111111111111111111111111111111111111111101
10000000000000000000000000000000000000000000000001
10101111111111111111111111111111111111111111110101
10100000000000000000000000000000000000000000000101
10111111111111111111111111111111111111111111111101
10000000000000000000000000000000000000000000000001
10101111111111111111111111111111111111111111110101
10100000000000000000000000000000000000000000000101
10111111111111111111111111111111111111111111111101
10000000000000000000000000000000000000000000000001
10101111111111111111111111111111111111111111110101
10100000000000000000000000000000000000000000000101
10111111111111111111111111111111111111111111111101
10000000000000000000000000000000000000000000000001
10101111111111111111111111111111111111111111110101
10100000000000000000000000000000000000000000000101
10111111111111111111111111111111111111111111111101
10000000000000000000000000000000000000000000000001
10101111111111111111111111111111111111111111110101
10100000000000000000000000000000000000000000000101
10111111111111111111111111111111111111111111111101
10000000000000000000000000000000000000000000000001
10101111111111111111111111111111111111111111110101
10100000000000000000000000000000000000000000000101
10111111111111111111111111111111111111111111111101
10000000000000000000000000000000000000000000000001
10101111111111111111111111111111111111111111110101
10100000000000000000000000000000000000000000000101
10111111111111111111111111111111111111111111111101
10000000000000000000000000000000000000000000000001
10101111111111111111111111111111111111111111110101
10100000000000000000000000000000000000000000000101
10111111111111111111111111111111111111111111111101
10000000000000000000000000000000000000000000000001
10101111111111111111111111111111111111111111110101
10100000000000000000000000000000000000000000000101
10111111111111111111111111111111111111111111111101
10000000000000000000000000000000000000000000000001
10101111111111111111111111111111111111111111110101
10100000000000000000000000000000000000000000000101
10111111111111111111111111111111111111111111111101
10000000000000000000000000000000000000000000000001
10101111111111111111111111111111111111111111110101
10100000000000000000000000000000000000000000000101
10111111111111111111111111111111111111111111111101
10000000000000000000000000000000000000000000000001
10101111111111111111111111111111111111111111110101
10100000000000000000000000000000000000000000000101
10111111111111111111111111111111111111111111111101
10000000000000000000000000000000000000000000000001
10101111111111111111111111111111111111111111110101
10100000000000000000000000000000000000000000000101
10111111111111111111111111111111111111111111111101
10000000000000000000000000000000000000000000000001
10101111111111111111111111111111111111111111110101
10100000000000000000000000000000000000000000000101
10111111111111111111111111111111111111111111111101
10000000000000000000000000000000000000000000000001
10101111111111111111111111111111111111111111110101
10100000000000000000000000000000000000000000000101
10111111111111111111111111111111111111111111111101
10000000000000000000000000000000000000000000000001
10101111111111111111111111111111111111111111110101
10100000000000000000000000000000000000000000000101
10111111111111111111111111111111111111111111111101
10000000000000000000000000000000000000000000000001
10101111111111111111111111111111111111111111110101
10100000000000000000000000000000000000000000000101
10111111111111111111111111111111111111111111111101
10000000000000000000000000000000000000000000000001
10101111111111111111111111111111111111111111110101
10100000000000000000000000000000000000000000000101
10111111111111111111111111111111111111111111111101
10000000000000000000000000000000000000000000000001
10101111111111111111111111111111111111111111110101
10100000000000000000000000000000000000000000000101
10111111111111111111111111111111111111111111111101
10000000000000000000000000000000000000000000000001
10101111111111111111111111111111111111111111110101
10100000000000000000000000000000000000000000000101
10111111111111111111111111111111111111111111111101
10000000000000000000000000000000000000000000000001
10101111111111111111111111111111111111111111110101
10100000000000000000000000000000000000000000000101
10111111111111111111111111111111111111111111111101
10000000000000000000000000000000000000000000000001
10101111111111111111111111111111111111111111110101
10100000000000000000000000000000000000000000000101
10111111111111111111111111111111111111111111111101
10000000000000000000000000000000000000000000000001
10101111111111111111111111111111111111111111110101
10100000000000000000000000000000000000000000000101
10111111111111111111111111111111111111111111111101
10000000000000000000000000000000000000000000000001
10101111111111111111111111111111111111111111110101
10100000000000000000000000000000000000000000000101
10111111111111111111111111111111111111111111111101
10000000000000000000000000000000000000000000000001
10101111111111111111111111111111111111111111110101
10100000000000000000000000000000000000000000000101
10111111111111111111111111111111111111111111111101
10000000000000000000000000000000000000000000000001
10101111111111111111111111111111111111111111110101
10100000000000000000000000000000000000000000000101
10111111111111111111111111111111111111111111111101
10000000000000000000000000000000000000000000000001
10101111111111111111111111111111111111111111110101
10100000000000000000000000000000000000000000000101
10111111111111111111111111111111111111111111111101
10000000000000000000000000000000000000000000000001
10101111111111111111111111111111111111111111110101
10100000000000000000000000000000000000000000000101
10111111111111111111111111111111111111111111111101
10000000000000000000000000000000000000000000000001
10101111111111111111111111111111111111111111110101
10100000000000000000000000000000000000000000000101
10111111111111111111111111111111111111111111111101
10000000000000000000000000000000000000000000000001
10101111111111111111111111111111111111111111110101
10100000000000000000000000000000000000000000000101
10111111111111111111111111111111111111111111111101
10000000000000000000000000000000000000000000000001
10101111111111111111111111111111111111111111110101
10100000000000000000000000000000000000000000000101
10111111111111111111111111111111111111111111111101
10000000000000000000000000000000000000000000000001
10101111111111111111111111111111111111111111110101
10100000000000000000000000000000000000000000000101
10111111111111111111111111111111111111111111111101
10000000000000000000000000000000000000000000000001
10101111111111111111111111111111111111111111110101
10100000000000000000000000000000000000000000000101
10111111111111111111111111111111111111111111111101
10000000000000000000000000000000000000000000000001
10101111111111111111111111111111111111111111110101
10100000000000000000000000000000000000000000000101
10111111111111111111111111111111111111111111111101
10000000000000000000000000000000000000000000000001
10101111111111111111111111111111111111111111110101
10100000000000000000000000000000000000000000000101
10111111111111111111111111111111111111111111111101
10000000000000000000000000000000000000000000000001
10101111111111111111111111111111111111111111110101
10100000000000000000000000000000000000000000000101
10111111111111111111111111111111111111111111111101
10000000000000000000000000000000000000000000000001
10101111111111111111111111111111111111111111110101
10100000000000000000000000000000000000000000000101
10111111111111111111111111111111111111111111111101
10000000000000000000000000000000000000000000000001
10101111111111111111111111111111111111111111110101
10100000000000000000000000000000000000000000000101
10111111111111111111111111111111111111111111111101
10000000000000000000000000000000000000000000000001
10101111111111111111111111111111111111111111110101
10100000000000000000000000000000000000000000000101
10111111111111111111111111111111111111111111111101
10000000000000000000000000000000000000000000000001
10101111111111111111111111111111111111111111110101
10100000000000000000000000000000000000000000000101
10111111111111111111111111111111111111111111111101
10000000000000000000000000000000000000000000000001
11111111111111111111111111111111111111111111111111