NO textures/north.xpm
SO textures/south.xpm
WE textures/west.xpm
EA textures/east.xpm

F 100,100,100
C 200,200,200

1111111111111111111111111111111111111111111
1000000000110000000000001000000000000000001
1011000001110000000000001000000000000000001
1001000000000000000000001000000000000000001
1011000001110000000000001000000000000000001
1001100000111011111111111000000000000000001
1111011111111101110000001000000000000000001
1111011111111101110101001000111111111111111
1100000011010101110000001000100000000000001
1000000000000000110000001000100000000000001
1000000000000000110101001000100000000000001
1100000111010101111101001000100000000000001
1111101111111111011110100011N0000000000001
1111111111111111111111111111111111111111111
