NO textures/north.xpm
SO textures/south.xpm
WE textures/west.xpm
EA textures/east.xpm

F 100,100,100
C 200,200,200

           111111111
          11000000011
         110000000011
        1100000000011
       11000000000011
      110000000000011
     1100000N0000011
    11000000000001
   110000000000011
  1100000000000011
 110000000000011
11000000000011
100000000011
1111111111
