NO textures/north.xpm
SO textures/south.xpm
WE textures/west.xpm
EA textures/east.xpm

F 100,100,100
C 200,200,200

111111111111111111111111111111
100000001000000010000000100001
101111101011111010111110101101
101000101010001010100010101101
101010101010101010101010101101
101010101010101010101010101101
101010001010101010101010100001
101011111010101010101011111101
10N010000010101010001000001101
101011111110101111101111101101
101000000000100000001000101101
101111111111111111111110101101
100000000000000000000010101101
111111111111111111111110101101
100000000000000000000000101101
101111111111111111111111101101
100000000000000000000000001101
111111111111111111111111111111
