NO ./textures/north.xpm
SO ./textures/south.xpm
WE ./textures/west.xpm
EA ./textures/east.xpm

F 220,100,0
C 225,30,0

1111111111
1000E000011111111111111111111
100000100000000000000000000001
10000000011111111111111111111
1111111111
