NO textures/north.xpm
SO textures/south.xpm
WE textures/west.xpm
EA textures/east.xpm

F 100,100,100,50
C 200,200,200

111111
100001
10N001
100001
111111
