F 76,76,76
C 99,99,99

NO ./textures/north.xpm
SO ./textures/south.xpm
WE ./textures/west.xpm
EA ./textures/east.xpm

1111111111111111111
10W1001001001000001
1011000001000001001
1001001001111101111
1001111000001001001 11111
1000000000000001001 10001
1001111111111001001 11111
1111000000000001011
1000000001000000001
1111111111111111111

1111111
1000001
1111111