NO textures/north.xpm
SO textures/south.xpm
WE textures/west.xpm
EA textures/east.xpm

F 100,100,100
C 200,200,200

1111111
100N001
1000001
100S001
1111111
