NO textures/north.xpm
SO textures/south.xpm
WE textures/west.xpm
EA textures/east.xpm

F 18,53,25
C 153,204,255

111111111111
1   S      11
1          1
111111111111
100000000001
111111111111
11         1
111111111111
